+------------------------------------------------------------------------------+
|                                                                              |
|                                                                           @  |
|                                                                              |
|                                                                              |
|                                                                              |
|                                                                              |
|                                                                              |
|                                                                              |
|                                                                              |
|                                                                              |
|                                                                              |
|                                                                              |
|                                                                              |
|                                                                              |
|                                                                              |
|                                                                              |
|                                                                              |
|                                                                              |
|                                                                              |
|                                                                              |
|  %                                                                           |
|                                                                              |
+------------------------------------------------------------------------------+
